0000000000
0100001000
0111001000
0000100000
0100010000
0010001000
0001000100
0000110000
0110000000
0000000000
