0001111000
0100001010
0111101010
0010400310
1010101010
1216150000
1006151111
1011100000
0000111110
1110000000
