44000001011110000000
01111101000100111010
51600101010000100010
51610101010100001010
51610120010131111010
01010101000101001010
01010101110000010000
01010000000111111110
00010111010100000100
11110000010001101101
00011110111100001000
01010000100001101010
01010110101001001010
00000100001011011010
01010111011000001000
01010100000010100010
11010101111110111010
00000000000100010010
01111101110101000110
00000000000001110000
