0001111000
0100001010
0111101010
0010000010
1010101010
1010200000
1000101111
1011100000
0000111110
1110000003
