0001111000
0100001010
0111101010
0010000310
1010101010
1210100000
1004101111
1011100000
0000111110
1110000000
