0000000000
0002000000
0000010000
0000010000
0000110000
0000000000
0010000000
0010030000
0010000000
0000000000
