2000000000
0010000000
0010000000
0010000000
0010000000
0010000000
0010000000
0000000000
0000000000
0000000003
