2000000000
0000000000
0000011100
0000111100
0001111100
0011111000
0011110000
0011100000
0000000000
0000000003
